12
6:6:2
1:2:0:2:0
2:3:0:2:0
3:1:1:3:0
4:5:1:2:0
5:0:3:3:0
6:4:4:2:0
7:0:0:2:1
8:1:4:3:1
9:2:2:2:1
10:2:3:2:1
11:2:5:2:1
12:4:3:2:1