12
6:6:2
1:2:3:2:0
2:1:0:2:0
3:5:0:3:0
4:0:1:3:0
5:1:2:3:0
6:3:3:2:0
7:0:4:2:0
8:4:4:2:0
9:2:0:2:1
10:2:2:2:1
11:4:3:2:1
12:1:5:3:1