11
6:6:2
1:2:0:2:0
2:3:0:2:0
3:1:2:2:0
4:3:2:2:0
5:0:4:2:0
6:1:4:2:0
7:5:4:2:0
8:4:0:2:1
9:4:3:2:1
10:2:4:3:1
11:2:5:3:1