12
6:6:2
1:2:0:0:2
2:3:0:0:2
3:1:1:0:3
4:5:1:0:2
5:0:3:0:3
6:4:4:0:2
7:0:0:1:2
8:1:4:1:3
9:2:2:1:2
10:2:3:1:2
11:2:5:1:2
12:4:3:1:2