8
6:6
1:2:0:0:2
2:0:0:0:3
3:5:0:0:3
4:3:4:0:2
5:3:0:1:2
6:1:2:1:3
7:4:4:1:2
8:0:5:1:3