13
6:6:2
1:2:2:2:0
2:3:0:2:0
3:1:1:2:0
4:0:2:2:0
5:3:2:2:0
6:1:3:2:0
7:0:4:2:0
8:4:4:2:0
9:5:4:2:0
10:4:0:2:1
11:4:3:2:1
12:2:4:2:1
13:1:5:3:1