8
6:6:2
1:2:0:2:0
2:0:0:3:0
3:5:0:3:0
4:3:4:2:0
5:3:0:2:1
6:1:2:3:1
7:4:4:2:1
8:0:5:3:1